1111111111111111111111111111111111111111111111111111111111111111111111
1000000111111111111111111111111111111111111111111111111111111111111111
1111111111111111111111111111111111111111111111111111111110111111111111
1111111111111111111111111111111111111111111111111111111110011111111111
1111111111111111111111111111111111111111111111111111111110000111111111
1111111111111111000011110001111100000000100111111111111110000111111111
1111111111111000000011110000001111011111110111111111111110000011111111
1111111111000000000011110000000000011111110111111111111110000001111111
1110000000000000000011110000000000111111110111111111111110000000111111
1111000000000000000011110000000000001111110000000011111110000000011111
1111111111111111111111111111110111111111111111111011111111101100101111
1111111111111111111111111111100011111111111111111011111110000000000111
1111111111111111111111111111100011111111111111111011111110000000000011
1111000000000000011111111000000000000000000011111000011110000000000001
1110000000000000001111110000000000000000000011111100011110000000000001
1111000000000000011111111001111000001111100011111000001110000010000001
1110000000000000011111111000000000001111100011111000001110000000000011
1111100000000000011111111000000000001111100011111100001110000000000111
1111111000000000000001000000000000001111100011111100000000000000001111
1111100000000111001001000000001111111111111111110001111110000000011111
1111111100000100010001010010000000111111111111110001111110000000111111
1111000000001000001000000000001111111111111111110001111110000001111111
111111100000000000000P100100000000000000000000000001111110000011111111
1111111111100000000000000000011111111111111111000001111110000111111111
1111111111111110000111000111111111111111111111111111111110001111111111
1111111111111111111111111111111111111111111111111111111110011111111111
1111111111111111111111111111111111111111111111111111111110111111111111
1111111111111111111111111111111111111111111111111111111111111111111111
1111111111111111111111111111111111111111111111111111111111111111111111